4,4,4,4,4,4,4,4,4,4,4,4
4,10,8,2,8,8,8,8,8,8,9,4
4,6,1,1,1,1,1,1,1,1,5,4
4,6,1,1,1,1,1,1,1,1,5,4
4,6,1,1,1,1,1,1,1,1,5,4
4,6,1,1,1,1,1,1,1,1,5,4
4,6,1,1,1,1,1,1,1,1,5,4
4,6,1,1,1,1,1,1,1,1,5,4
4,12,7,7,7,7,7,7,3,7,11,4
4,4,4,4,4,4,4,4,4,4,4,4
