1,1,200,1,1,1,1,1,1,1,1,1
1,1,0,0,0,0,0,0,0,0,6,1
1,0,0,0,0,0,0,0,0,0,6,1
1,6,6,0,6,6,0,0,1,0,6,1
1,0,0,0,0,6,0,1,0,0,6,1
1,0,2&herb,0,0,0,0,0,0,0,6,1
1,0,0,0,0,6,0,0,0,0,6,1
1,1,1,1,1,1,1,1,1,100,1,1
