1,1,200,1,1,1,1,1,1,1,1,1
1,0,0,0,0,0,0,0,0,0,2&book,1
1,0,0,0,0,1,1,0,0,0,0,1
1,0,0,0,0,1,1,0,0,0,0,1
1,0,1,1,0,2&herb,0,0,1,1,0,1
1,0,1,1,0,0,0,0,1,1,0,1
1,0,0,0,0,0,0,0,0,0,0,1
1,1,1,1,1,1,1,1,1,100,1,1
