1,1,200,1,1,1,1,1,1,1,1,1,1,1,1
1,0,0,0,0,0,1,0,0,0,0,0,0,2&block,1
1,0,0,1,0,0,0,0,0,0,0,1,0,0,1
1,0,0,0,0,6,6,6,6,0,0,0,1,0,1
1,0,0,0,0,6,2&blade,2&book,6,0,0,0,0,0,1
1,6,6,0,6,6,0,0,6,6,6,0,6,6,1
1,1,0,0,0,0,0,0,0,0,1,0,0,0,1
1,0,0,0,0,0,0,0,0,0,0,0,0,0,1
1,2&herb,0,0,0,1,0,0,1,0,0,0,0,1,1
1,1,1,1,1,1,1,1,1,1,1,1,100,1,1
