1,1,200,1,1,1,1,1,1,1,1,1,1,1,1
1,0,0,1,6$v,0,0,0,0,1,0,0,0,0,1
1,0,0,0,301$h,0,0,0,0,0,0,0,2&blade,0,1
1,0,0,0,6$v,0,0,0,0,0,0,0,0,0,1
1,0,0,0,6$v,1,0,0,0,0,0,0,0,0,1
1,0,1,0,6$ll,6$h,301$v,301$v,6$h,6$ur,0,0,0,1,1
1,0,0,0,0,0,0,0,0,6$v,0,0,0,0,1
1,0,2&herb,0,0,0,0,0,0,301$h,0,0,0,0,1
1,0,0,0,0,0,0,0,1,6$v,0,0,0,0,1
1,1,1,1,1,1,1,1,1,1,1,1,100,1,1
